R 1400 1800
NO includes/greystone.png
SO includes/wood.png
WE includes/mossy.png
EA includes/colorstone.png
S includes/barrel.png
F 22,100,80
C 10,30,10
  1111111111111111111
  1000000000110000001
  1200000001110000111
1111220S00000000011
100000001110000000011
1000000000110000011
1111000220110001111
11110000000011101111
1100000011010101111
1111111111111111111